##############################################
##############################################
#######                    ###################
#######                    ###################
#######                    ###################
#######                    ###################
#######                    ###################
#######                    ###################
#######                    ###       #########
#######                    ###       #########
#######                    ###       #########
#######                    ###       #########
##############    #############    ###########
##############    #############    ###########
##############    #############    ###########
##############    #############    ###########
#######                            ###########
#######                            ###########
#######                            ###########
##############################################
##############################################
##############################################
##############################################
##############################################
##############################################
##############################################